
F 55,55,000

	SO	./mandatory/textures/south2.xpm
 	
C 55,255,255
EA ./mandatory/textures/east2.xpm
NO	./mandatory/textures/north2.xpm	


		WE ./mandatory/textures/west2.xpm  

            DR ./bonus/textures/door.xpm 



 
 
 111  
 101
1111111111111111111111111111111111111111111111111111111111111111111111111111111111111111111111111111111111111111111111111111111111111
      10000000000000000000000000000000000000000000000000000000000000000000000000000000000000000000000000000000000000000000000000000001  
 11111101D11111111111111D111111111111111111110111111111111111111111111111111111111111111111111111111111111111111111111111111111111111
 1000000000000000000000000000000000000000000101 
 100000000E000000000000000000000000000000000101
 1000000000000000000000000000000000000000000101
 10000000000000000000011D1110000000000000111101
 10000110001100111000110001100011000110001  101
 10000110001100111000110001100011000110001  101 
 10000000000000000000111D1110000000000000111101 
 1000000000000000000000000000000000000000000101
 1000000000000000000000000000000000000000000101 
 1000000000000000000000000000000000000000000101
 11111110111111111111111D1111111111111111111101
       1000000000000000000000000000000000000001
       1111111111111111111111111111111111111111
 1
 1
 1
 
 
 

