
	
 F 55,55,0
 	
EA ./mandatory/textures/east2.xpm
NO	./mandatory/textures/north2.xpm	
  C 55,255,255
	SO	./mandatory/textures/south2.xpm
		WE ./mandatory/textures/teste.xpm    






 
 111  
 101
11111111111111111111111111111111111111111111111
      10000000000000000000000000000000000000001
 1111110111111111111111111111111111111111111101
 1000000000000000000000000000000000000000000101
 10W0000000000000000000000000000000000000000101
 1000000000000000000000000000000000000000000101
 1000000000000000000000000000000000000000111101
 10000110001100011000110001100011000110001  101
 10000110001100011000110001100011000110001  101
 1000000000000000000000000000000000000000111101
 1000000000000000000000000000000000000000000101
 1000000000000000000000000000000000000000000101
 1000000000000000000000000000000000000000000101
 1111111011111111111111111111111111111111111101
       1000000000000000000000000000000000000001
       1111111111111111111111111111111111111111
 1
 1
 1

